skull: scull
sky: skiy
slammed: slamed
slave: slav
sled: slad
sleep: slep
sleeping: sleping slepping
sleepy: sleppy
sleet: sleat
sleeve: sleave
sleigh: slay sliegh
slice: slise
slid: slided
slide: slid slied slyed
slight: slite
slightly: slighlty
slimmer: slimer
slimmest: slimest
slip: slep
slipped: sliped
slipper: sliper
slippers: slipers
slippery: slipery
sloping: slopping
slow: slo
slowly: sloly slouly
slums: sulmss
small: smal
smaller: smaler smoler
smallpox: small_pox
smashed: spached
smell: small smel smelt
smile: smil
smiling: smilin
smoke: smock smok
smoking: smokeing smooking
smooth: smoth
snake: snak
snakes: snaks
sneak: sneek
snobby: snoby
snow: sno sow
snowball: snow_ball
snowballs: snow_ball
snowing: showing
so: said san sane sat saw slow soe soen sol som some sor sow sung yahet
so-called: sa-called so-call so-colled so_call so_called socale socalled sol-called
so_forth: so-forth soforth
soak: soke
soap: sope
sociable: socable
social: socal
society: sciety socity
socks: scoks sock
soft: saft
software: sofware
softy: softee
soil: soile sole
soldier: solger
soldiers: solders solgers
sole: soul
solely: soley
solemn: Solome Solomn psalm salem salemn sallom salmon salumne slaom slomue solam solem soleman solemon solemum solemun solenn soleom soleum solid solim solium sollem sollom sollum solm solman solme solmem solmen solmn solmon solmun soloem solom solomen solomn solomon solon soloum soloun soluem solum solume solumn solumun solunm soluom sullen suman
solid: soled
solo: solow
solve: slove
solving: soli
some: same sane so
some_day: someday
some_other: someother
some_time: sometime
somebody: sombody some_bodiy
somebody's: somebodies
somehow: some_how
someone: saneone some-one some_one somo somone sumone
someone's: some_ones
something: som_thing some-thing some_thing sometheing somethig somethink somthing
sometime: somtime
sometimes: some-times some_time some_time's some_times sometime somtimes somtims sum_time sumtimes
somewhat: somwhat
somewhere: somewere somewher somwere sumwer
son: sun
sons: sands som son sones soon souns sun sunent suns sus
soon: son sone sooned
sooner: soner sonner
sophomore: sophmore
sore: saw sor
sorority: Soroity carority ceroraty cesarenty cireualey ciroarity currority sacroity sarity saroaities saroaraty saroity sarority sarorrity sarrority saurtly scarority scoratity scoritory scoritty secority senority serariety serarity seroity serority seroroty serroity serroraty seurorty shorariety shrority sirority sirroraty snoraty sohreyety soiority soirerty solarity soraraty sorarity soreity soretry soriciety soriety soriority soririty soritety sority soroarate soroarite soroarity soroartity soroatly soroiety soroity sororeity sororety sororiety sororitity sororoty sorotory- sorourity sorowety sorrity sorrodily sorroity sorroraty sorrority sorrourity souraty sourity sournate sourorely sourority suaally suarity sulroarity suracaty surally suralty suraraly suroarity surority surraty surroitty surrority surrourity surrowey syrority
sorry: sory
sort: sorte sorted sot sought sourt sout
sought: saught sort
soul: sole
sound: noise sad sade sader saend saher sand sanded sank saod saund sawd sel send sewnd shale sod sode son sond sone soned song sonud sood soud souned sounet sournd sowd sownd stay stead suled sund sw
soup: sup
source: aource sauce sorce sourse
sources: sorces souces
south: self sorth soth
southern: citune earthren sam samine sathern sathot savan saven savon sethenth shunden shuthen sorth sorthern sothen sother sothern sothurn souen sourt southan southen southend souther southin southorn southren stathn sthon stubborn suafix sudden sudderly suden sueone sufact suffen sunden sunley sunthing suoth suothen suse sutan suthen suthern suthn suthon sutthern suvel suven
souvenir: souviner
sovereignty: sovreignty
sow: sew
spa: spar
space: spase
spacecraft: saincad save_raf searse_caft sesp_crad sher slopk_cleng spac_craft spac_croft space_caft space_card space_carft space_cart space_craf space_crafed space_craght space_cratf space_crath space_crift space_crofed space_crouft space_croved space_cruft space_racht spacecraf spacecrawf spacs_crof spair_garr spare_crafed spase_caft spase_cruft spash_cared spast_crath spate_carf spats_crat spcruf spea_cofed spercrift spish_cart
spacious: spaceous
spade: spad
spare: his score ser sereine sgre shaper shar share spaip spair spar spear sper spere spu ster
sparrow: sporrow
sparsely: sparcely
speak: speack speck spek
speaker: speacker
speakers: spaekers
speaking: speacking speeking speking
spear: speer spere
special: beshul peslall real sbesll seales sech secheul secial selel seleo sepcil sepical seter shechel sola sp space spacial spacil spaech spail spaisile spall spasall spashel speacal speacial speacil speacle speaclil speacly speaical speaicl speail speal speally spealy speashell speashle speasial speasll specail specal specber speceall specel specele specell spechal speche spechel spechile special speciall speciel specil specile specill specitle specle specli specor specsie spectial specull speial speicail speical speice speicel speichy speicial speiciall speicil speicl speil speiple speishel spelich spell spelloll spelse spelshel sperclruy spersh spesal spescil spesh speshal speshall speshel speshell speshil speshl speshle speshull spesial spesil spesl spesle speslel spesll spessl spesule spic spical spicale spicechall spicel spicial spicl spicterts spie spieal spiecal spiecel spiecil spiect spieica splended spohal spslie stasul steshle suhlue wist
specialization: sececialization
specialize: special
specializes: specialisises
specific: Paciffic Pacific Specifa Specific pacific pacquik passific pecific pecifick picipic sespecific spacific spasific spcific specefe specefic specfic speciefic specifac specifect speciffic specifficy specifica specifich specifict specipik specipit specsiface spefick spescivic spesific spesifict spficsic spiciefic spiciffic spicific spicivic spiecivic spisific spsific spyfic
specifically: pacfically pacifacly paciffically pacifficlly pacifical pacifically pacificaly pacifictly paficaly pasificaly pecificual pecificule persivacly pesifiecally phacialy phacificially phificall phyfically physifically picfically picificly picpisy possivically pussificulty pysifily sepecifically sipaficaly spacically spaciffically spacifically spacificaly spacificially spacificly spacifilly spacilly spacivicaly spcioicately spcyphicically specefically speceficalsee specephicly specfically speci specifacly specifacully specifcale specifcally specifecely specifecly specifecully speciffically specifi specific specificalely specificaly specificately specificely specifickly specificlly specificly specificually specificulty specifiecaly specifucally specifuclly specify specio speciocally specip speciphicly speclovel spectf spectfically spectioly specyically speecificully speficically speficict spesificale spesifically spesificaly sphecificly sphificly sphisisly spicificily spicificly supacificly
specimen: Specimen Specimens scecameon secpamon sepcimen sepecimen sepesaman sepesiment sepesinman sepesion soecimaan spacimen speamend specaman specament specamin specemen specemens specement specemin speciemen speciement specienens speciman specimann specimend specimene speciment speciments specimine specimn specimun specinen specionm specismen specium speciumen specman specmen specmicn speecaman speicemen speicman spemans spesciment spesimen spesiment spesimon spessimen spicemen spiciman spiecman spiecmen spieimins
specimens: secpimens sepamns sepecife sepemends sipumens speasmens specamens specamins specemunt specfunens speciamans speciamens speciamns specicims speciemends speciemens speciements speciemn speciems speciemuns specimans specimen specimen's specimends specimenence speciments specimims specimines specimins specimns specimums specimuns specinens speciums specumens specusamends spedicemas speicimens spenious spesements spesiamen spesment spicemens spicements spicimens spicimuns spiecman spisemans spuciman suppictments
specs: spec's
spectroscopy: spectoscopy
speech: speach
speed: spead
spell: spll
spelling: speeling speling sprlling
spent: spend
sphere: spere
spherical: sperical
spider: spiter
spill: spil
spin: spen
spinning: saing sapping seepping sereng sin sindn sining sinning sinping sipppe skinning soling spang spcing spen spening spin spineng sping spinging spining spinng spinnig spinny sun_coming
spirit: spirt
spirits: sperits
spiritual: pirtral sipural spcerial spearacher spearitial speartiual speiritually speratral speratual speratural sperical speritual spertial spertiaul spherical spieratually spirchial spirical spirisul spirital spiritial spiritiaul spirititual spirituall spiritually spiritul spiritural spiriturel spirlial spirt spirtful spirtial spirtional spirttual spirtual spirtural spirurel spitirial spitrial spitural sprirtual sprital spritially spritiual spritual spritule spritural spulcure spuritily
spirituous: spiritous
spit: spite
spiteful: spitefull
splendid: macknifisent maknivson pefect pled pseded remackuble remarkable sandid sates sbleded sblended sblled sed sedid separted sepper sleadet sleded sledid slended slendid slened slped slpended spader spedin speldid spelended spelendid spelled spellend spend spended spendid spendoded spened spenled spented spildend spinted spland splanded splanted spleand spleded spledid spleind splel splend splende splended splenden splender splenderd splendide splendied splendod splendourd splened splenid splented splet spliend spliened splindid spnelldid spolened spordid spread sprended stlendid sudend
splinters: spliters
split: spilt splite
spoil: spol
spoiled: spoled
spoke: spock spok spook
spontaneously: spontaneos
spoon: spon
spoons: spoon
sport: short spot sprot
sports: storts
spot: shot sopte spat sport spout srot stop
spotted: spoted
sprained: sprad sprianed
spread: spred
spring: sping
sprinkle: sprinkel
squad: sqird
square: sqare squair squar
squeak: squek
squeaks: squeeks
squealing: skwelling
squeeze: squeese squeze
squirrel: squrrel
squirting: squrting
stable: stabel
stack: stake
stadium: staydium
stage: shag stag
stair: star stare
stairs: stars steres
stake: stack steak
stalk: stork
stammered: stamerd
stamp: stanp stap
stand: sand
standard: standed standerd stnadard
standardizing: stanerdizing
standing: sanding stading
stands: standes stans
star: stare stau str
starch: starge startch
stare: stair steir
stars: sars sart sharn sier sots stairs stare starers stares ster stores stors stres strue sys
start: stab stat
started: sarted serted start
starter: strater
starting: staring startin
starts: startes
starve: stave
state: stat
stately: statelly
statement: statment
statements: stetemets
states: stats
stating: stateing
station: sashon satshtions stachon staeing staion staiton stands stanshon stanton staon starch starns stashon stason staytion steason stolaon ststion stusion
stationary: stationery
stationery: stationary
statistics: Statics Statistics certistices cististics distiticks sasticics sastictic sastictics satistics sestistics setistics sististic sitictis sitisitice sitistic sitistics sitisticts sotistic stacatic stacticits stactics stacticts stastics stastictics stasticties stastistis stastitics statastics statatics statesic statestics statices staticies staticisics staticits statics statictcs statictics staticts statistic statisticks statisticts statistikes statithics statitics statitus statstics status staylistic stectics steriaties stesticics stetistic stetistics stictics stictsics stictuct stilistus stisicks stistic stistics stistictics stisticts stitate stitictics stiticts stitistics stituatices stoctitics stostics sttistics stucktiscus stusicitic stustitices stutecticks stutics stutistics stuttish succticts suspetious sustics sustictes sutices sutistick sutistics sutities systicts sytistics tististicts
statue: statu
stay: sart sta stae staye
stayed: stad stade staed stay stayd steted
staying: staing
steady: stedy
steal: steel stel
stealing: stelling
steam: steem stem
steamer: stemer
steel: steal
steep: steap step
steer: stear ster
stenographer: stenografer
step: stap
stepped: steped
steps: staps
stick: skite stik
stick-insects: stickin-sects
stiff: stif stife
sting: steng
stir: ster stur
stirring: stirrin
stirrups: stirups
stitch: stich
stitches: shichis stiches
stock: stark
stockroom: stock_room
stockings: stokings
stole: stol stold stull
stolen: scolend solnd stern stolern stollen stopen
stomach: bel samke scemkmen sese seumkote slomac slomakc snumik somes somock somtac sortmach soser stamac stamach stamoc stamoch stimer stoamac stoamc stoamch stom stoma stomac stomach stomache stomack stomact stomak stomake stoman stomarck stomatc stomc stomch stomche stomck stome stomeak stomec stomech stomer stomi stomic stomick stomik stomitc stomk stomo stomoak stomoc stomot stomouc stomuch stonec stormach stormick stoumac stoumak stoumi stoumoc strom stubuck stum stuma stumac stumace stumache stumack stumagh stumak stumarc stumc stumck stume stumeak stumec stumeck stumek stumer stumerk stumi stumic stumk stumlmick stummec stummi stumo stumoc stumoh stumok stumuc stumuck stumuk stumuke stunk sumerk summok sumoch thomeke tumer tumerk tumm
stone: ston
stood: stod
stop: shop stap
stopped: stoped
stopping: stoping
store: stor
storey: story
storeys: stories
stories: stores story storys
storm: strom
story: sorry sorty sory stare stary store storey storh stort
stove: stov
straight: strait
straighten: straiten
strain: stran
straining: strainin
straitjacket: straightjacket
strange: strang
stratagem: strategem
strategically: stratigically
strategy: stratagy
straw: strarw strow
strawberries: strawberrys
strawberry: strawbery
straws: strawes
stream: streem strem
street: sater seat seet seets sratt sreet sret st state steat stee steer steert steest steet steete steew stir streat stret sweet
strength: streangth strengh strenght
strenuous: sprenuious standeile stendious stenious stenous storanious straines strainous strainuest strainulous strainuous strainurous strainuss strandiss straneous stranious stranuas stranuious stranuiss stranuous stranuses streanious streanous streguas streinous stremious strendously streneous strenerous strengenious strengeous strengheous strenguous strenious streniously strenius strenlium strenlous strennous strenoues strenouos strenouous strenous strenrus strenuas strenueas strenues strenueus strenuious strenuis strenuless strenulus strenumious strenuos strenus strenyous strinious strumious strveous stumate tranuis treneous trenious trenuous
stretch: streach strech
stretched: streched
strict: srict stict strick stricked stricted striked
strictest: strictist
strike: sricke strick stricke
string: sting
strong: strog
strongly: stongly
struck: struk
structuralization: stu
structure: strcture structrue structu stu
structures: structurs
struggle: stra strugle
stubborn: shuden stubbon stuborn
stubbornness: stubborness
stuck: stok stuk
student: studend sudent
students: studens
studied: studed studyed
studies: studys
studying: studiing studing
stuff: stof stuf
stump: stomp
stupid: spoped stuped stupied
style: stile
stylish: styleish
sub-prefect: subpreyfect
subject: subgect subjects subjuct sugest
subjects: shutgex subjecks subject subjectes
submit: submite sumit
subscribers: suscribers
subscription: subscribtion
subsequent: subsequant subsiquent
substantial: substantal
substitute: subsitute
substructures: subsructures
subterranean: saltraron spitrainen su_tranian sub-terranean sub-terranian sub_terrainian subaranain subbteranain subbtrain suberamium substeranium subtarainion subtaraneon subtaraniam subtaranian subtardinen subtarranean subtarranian subtearanean subteraem subterain subterainam subterainean subterainein subterainem subterainen subterainer subterainian subterainin subterainio subterainium subteranean subteraneing subteranian subteranien subteranin subteranion subterannean subteranum subterdinean subterian subterianam subtermid subterraean subterraenean subterrainean subterrainern subterranian subterrean subterresian subtiranean subtoraneman subtorum subtrainyorn subtranen subtrau subtrerainiam subturanean subturanium sudderanium sudtranean suparanyan superdining suppertan suprutes supteranion supteranium suptermatian supterraane supterrinen suptranet suptranon supturian surnturnany surteranin suteranrepeiomene
subtract: subtrcat
suburb: suberb
suburban: sububan surburban
succeed: succed succede success suceed
succeeded: succeded suceeded
success: succes sucess
successful: sacksesful sacsesful saseful scucfull scuksefuly seccesful seceful secessful seckesful secsecful secsecfuly secseful secsesful sesesful sexcful sexself siccesefull succeful succesfel succesful succesfull succesfully succeshful successeful successfull successfuly succful succfull succsefull succsesful succsesfull succsessful succusfull suceful sucefull suceseful sucesfful sucesful sucesfull sucessful sucessfull sucfull suchesbull suchsefull suckcesfull suckessful sucksesful sucksesfull sucksfull sucseful sucsefully sucsesfle sucsesful sucsesfull sucsesfult sucsessful sucsessfull sucsful sucsfully sucsselful sucssuful sukseful suksesfull surou surseful sursenful susesful suskfull sussecful sussefull sussfull sususful suxcessful suxsefal suxsesful suxsusful uscsful
successfully: succesfully suceessfully
successive: sucessive sucsesive
successor: succesor
succinctly: sucinctly
such: sach shuch suh suu
sudden: suden sudern
suffer: sufer
suffering: suufering
sufficient: cerfistiont saficient sefilshont sefisent sefishant serfercute serficant serficent serfichant serficiant serficint serfisant serfisemete serfisent serfishant serfishent serfishont sersfinhet sersishant servishant servishent shefint sherfishent shoofishtion shurfistent sifishant sirfisant sirfishant sirfishint soffoant sufeciant suffeciant suffecient sufficant sufficent suffichent sufficiant sufficuint suffiecent suffient suffisent suffishant suffitionent suficant suficent suficiant suficient sufient sufisant sufishant sufishent sufishunt surefish surfend surfeshant surfeshement surfficant surficant surficent surficiant surficient surficsut surfieshent surfinent surfishant surfishate surfishent surfishiat surfistion surfitiont survition sutticant
sufficiently: safishently safrishtonly savantly scifently scifiantly siffeicently sofecitently su_lfishently sucificently sufacionaly sufencently suffantly suffecently suffecienly suffecient suffeciently suffecienty suffectinely suffeicently suffeicuntly suffencely suffency suffently suffertinal suffescently suffialy sufficalny sufficantely sufficantly sufficeintly sufficency sufficenlly sufficentally sufficently sufficiantly sufficiency sufficienily sufficienlly sufficientally sufficiuntly sufficnnty suffiecentlly suffieciently suffienc suffiencentally suffienctly suffiency suffiently suffishly suffissioncy suffrintaly suffucently suficently suficiantly suficiently suficiontly sufiently sufisenlty sufishently sufishiently sufishunly sufitiently susficently syfishentally
suffrage: sufferage
sugar: suger
suggest: sugest
suggested: sugested sugjested uggested
suggestion: sugestion
suggests: sugests
suing: sueing
suit: suite sute
suitable: daul hartalon saball satur sauterble scobel set_tobal seuitable sitble siutable soebel soilal sooerble sootable sooterfull sootnel soots sotable sotaboll sotabul sotalb sotdole soteble soterbly soterpel sotoboll sotrdl soutabe sterball stewable stlo stoble suable subildbel suetebull suiable suirtdl suitaball suitabul suitble suiterble suiterbly suitibal suitible suitibul sulibale sutable sutball sutbue suteable suteaboule sutebul suterbell suterble suterbule suthall sutible sutiler sutl swterble totabull
suited: suted
suits: salt sende seses sete shirt soot sose sotes srat stuten suat sucts suir suit suite suites sune swet
sum: some
summaries: sumarys
summer: sumer
summerhouse: summer_house summerhouse
summertime: summer_time
sums: sum sume
sun: san son
sunday: sonday sunbay sundays suntday
sunk: sonk
sunny: sunney suny
sunshine: sunshin
superficial: superfical
superintendent: supertendent
superintendents: superintendants
superior: supperior
supersede: supercede
superstitions: supperstishons
superstitious: supersticious
supervision: supervison
supervisor: supervisser
supper: super
supplanted: surplanted
supplement: seypliment sublament such suclement sumplement superment supilement suplament suplemen suplement supliate suplimante supliment suplimente suplimite suppelement supplament supplemt supplent suppliment supplinen supplment supplument supplyment suppremat supulment suspulment
supplementary: suplementary
supplements: suplements
supplied: suplied
supplies: supply supplys
supply: suply
support: serport suport suppart
supported: suppore
supporters: suppoters
supports: support
suppose: serpose supose surpose
supposed: suposed suppose
supposedly: supposidly
suppress: supress
sure: cart cesh chor chore dhour gohet hearor isni roo sam sanet sar sare sarer saw sawr sham shar share shau shaw sheare shede sher shere shoar shoe shoes shon shone shoor shoower shor shorch shore shorer shou shour shoure shouw shouy show shoy shsre shur shure soa sofe someu soor sor sore soru sou sour sow srau sron staratr stean stheing sue syort thar
surely: surl surley surly
surface: cased caves cefes circuss cirface furfise saefe saeven safashes safe safis safit sarface scarefis scauce scues searface sefast sefic sefin sefis sefures send serce sercor serface serfast serfece serfers serfes serfese serfest serffes serfice serfies serfis serfise serfiss serfuss sersif serth serthface servecy serves servese service servics servise seturs sevace severs seves sfes sfis shaved shers siface sifce sift sirc sirfase sirfis sirge sirvce sitter sivise slives sorfers sorfes sorfess sreis srfeise stis suface sufes suffis sufice suficer sufise sunafipe sureface surefice surf surfars surfese surfice surfiece surfis surfise surpes surpise survise
surgery: surgere
surmounted: surmountin
surplus: caried cerflos cerplass cerplus certhes circleis circles circlus cirplace cirplese cirplist cirplus cirpuls cricos curculace curcus curplas rearlers sappats sappless scurplos sefers seirflace selpliss sepales seples seplese seplis sepples serfishe serpalce serplace serplas serplase serplause serplece serples serplese serpless serplice serplis serpluce serplurs serplus serpluse serpluss serpulse servis sirplace sirplass sirplause sirplus sleplus slp splers srrplas sternt suclurs suplace supless suplice supluors suplus supplase suppless surders surfless surlers surp surplace surplas surplase surpleas surplerce surples surpless surpliace surplie surplis surplise surplos surplouse surpluce surpluse surpluss surplut surpuse surrpluse
surprise: suprise surprice
surprised: serpisorzd suprise suprised
surprising: serpising supprising suprising
surrender: surender
surreptitious: sureptitous
surreptitiously: surruptitiously
surround: sorround suround
surrounded: csranded esrondid sarand sarnd sarouded scand serded serended seron seronded serounde serounded serounden serouned serrounded siroud sodded sorned soronded sounround sourounded srand sranded sreded sreeounded srelod srounded srowened srround suronded surouded suroued suround surounded surredened surroded surronded surrondered surroned surrouded surround surroundend surrouned surrownded surruded
surrounding: serounding sorrounding
surroundings: seroundings suroundings
survey: survay
surveying: servaying
surveys: servays survays
suspicion: sucipition sucpescision sucption sucspecon supesion supession supestion supicion supicsion supiosion supision supission supition supiucan suppemtant suppession suppicion supsicion supusion suscispition susficient susici susipession susipion susiption suspecian suspecien suspecion suspesion suspesious suspetion suspic suspican suspician suspicioned suspicious suspicison suspicition suspicoun suspicsion suspiction suspion suspiscion suspishion suspision suspisition suspission suspistion suspition suspusion susspicion susyption
swallow: swollow
swallowing: swalloing
swam: smim
swamp: swap
swap: swop
swear: swar sware swer
swearing: swearinge
sweat: swet
sweater: sweeter swetter
sweep: swep
sweet: swet
sweetest: sweetes
sweets: sweet
swell: swel
swept: sweped
swim: smim swin
swimming: smiwing swim swiming swming swmmer
swimming-pool: swiming_pool swimming_pool
swing: suing
switch: swich
swivel: swival
swollen: swolen
sword: soord sord
swung: swonge
syllable: silable sylable
syllables: sylables
symbol: synbol
symmetrical: symetrical symettrical
symmetry: cementry cemertire cemerty cemetarying cemetry cemitary cemitry cimatree cimatry cimertary cimetery cimetry cimitry cymitery semarty semetrie semetry semitary semtrey simatree simatry simertry simetary simetrey simetry simitary simitery simitray simitry simtary simutr smited sunertrey syermetre symatry syme symeatry symetery symetrey symetry symettry symitry symmatry
sympathetic: cimtictaty cympathetic scinfacious semithetic sempathetic sempathitice sempetic semphistic simasethe simithetic simpatacit simpathectic simpathegic simpathetic simpathic simpathidect simpercity simpethic simpicet simpithatic simpithetic simpotry sinpithetic smpasatic smpathic smpthatic spathety symaphatic symaphetic symapithet symapothic symathaic symathectic symathetic symathetice symathic symiphatic symitishes symophatic sympafacted sympathatic sympathectics sympatheic sympathethic sympathic sympathicits sympathitic sympathtic sympathy sympatic sympatics sympethatic sympethetic sympethic symphathetic symphathic symphatic symphethetic symphetic symphtatic symphtic symphytic sympiance sympothics sympothlect sympothly sympthatic sympthetic sympthitic symthetic symthic symthy synepethic synethic sypathetic sypathic sypathtic syphmathetics syptatheic sypthmetic systematic systematice systimetic thempathtic thimpethetic
sympathy: sympthy
synchronize: synshronise
synonymous: synonomous
system: sistem sysem
systematic: systermatic
systematically: systemetically
table: tabel tabl tasble
table-tennis: table_tennis
tables: table
tablet: tablit tablt
tacit: tasit
tackle: tackel takle
tackling: tackeling takling
tact: tacked
tag: tage
tail: tale tall
take: tack tacke taek tak talk teck
taken: tacen tacken taeken take taked takeing takeon takern takin taking talken tanking tarkan tecen theaen token tookony
takes: tack taks
taking: takeing takin
tale: tail
talent: talant
talents: tallents
talk: take toke
talkative: takativ
talked: taked talk
talking: taking talkig touking
tall: toll
tame: tam
tan: tain tane
tankard: tanker
tape-recorded: tape_recorded
tape-recorder: tape_recorder
tapping: tappin
tar: tare
tariff: tarrif tarriff
tarmac: tar_mak
tarmacked: tarmaced
task: tasked
taste: tast tayste
tattoo: tatoo
taught: teached thers thourght tort tought tuaght
tax: tacks
tea: tae tee
tea-maker: tea_maker
teach: tech tiece
teacher: taeche tcher teach teachur teachure teahcher teaher tearcher teasher teatcher teather teche techer tecter tocher
teacher's: tearcher ticher's
teachers: tacher tchers teacher teaches teahchers teahers tearch tearchers teatchers teature teatures techeler techers techershoy techet techeter tichers tinicher treacher
teachers': tcher teaches
teaching: teching
team: teem term
team-games: team_games
team-mates: teamates
teams: tem thea
tear: tair tare
tease: teas teese
technical: atecnicle attecnical nechniqual rablenackle tacal tackneccal tacknical tacnical tacnicle tacnitical tactnickle tactnicle taknickel taqneical techanical techenal techenical techical techicnal techinacal techinal techincal techinel techinial techinical techinicial technecal technechial technecil techneical technial technicale technichal technicial technickal technickle technicle technicol technincal techniqucol techniquely tecical tecimical tecinacal tecinal tecineckle tecinical tecionel teckinicital tecknacal tecknal tecknectieal tecknical tecknichel tecknickel tecknickkel tecknickle tecknicle tecknile teckniqual teckticle tecmacke tecmical tecnacle tecnecale tecnecial tecnecle tecnical tecnicale tecnicalle tecnichal tecnichel tecnickel tecnickle tecnicle tecnicol tecnicte tecnique tecticals tectinal tectincall tectional tectnacle tectnical tectnickle tectonal teknical teknicial tempnical tencial tenical tenichal tenitex tentinal texates texinal texnical texniccal textical textle textnal textnical ticinickle ticknickle ticncal ticnecal ticnicial trancale
technically: technecally
technique: tecnique
techniques: techiques tecniques tequniques
technological: tecl
technologically: tecln
tedious: tedeus tediuos tedius
teeth: teth theeth
telegram: telagram
telegraph: telagraph
telephone: telaphone telphone
telephoned: hetephonen lhonlaet talfon talford tallvon tallyfone teelyphoned telaphoned telefond telehponed telephed telephon telephone telephonied telepioned telepondes telepone teleponed telepound televoined telhonde teliphoned tellyphoned teloned telphone telpone telponed telpron telpted tepohed tepond
television: televison
tell: tall tel
telling: teling
tells: telles tels
telltaling: tell_tailing
temper: tempar tenper
temperament: temperment
temperature: aterau teamerature tecpel temetor temmper temparature temparte temparter temparture temparure tempater tempature tempeger tempem temperateure temperiture temperjor tempersh tempersher temperter tempertrag temperture temperute tempetchure tempetrue tempeture tempir temppure tempratar tempratur temprature tempreage tempreature temprecer temprecher tempreches tempresure tempreter tempreture tempricher tempriter tempritue tempriture temproter temptercher temptige tempurjure tempurtuse temputar temputure temreter temreture temt temter teperar tepuretire terperche theapitor tmera trar
tempered: temped
temple: tempel
temporarily: demporaly denficaly temarally temaraly temararlly temeperly temeraley temiparly temoaraly temoparaly temoraly temorarally temorarily temparaly tempararily tempariarly temparly temperairly temperalily temperally temperaly temperanly temperaraly temperarily temperarly temperatory temperially temperorarily temperrarially temperreally temporailly temporaily temporairely temporairily temporairly temporalary temporalily temporally temporalry temporaly temporarally temporarelly temporarely temporarially temporarialy temporarilly temporarlly temporarly temporarolly temporaroly temporarrly temporary temporaryly temporately temporayally temporayly tempore temporeraly temporially temporialy temporiarly temporily tempororialy tempororily temporrally temprorally temptorary tenarary tenpiorly tenporalely tenpuartly
temporary: temaparay temerary temopary temorary temparary temparey temparory tempary tempenary temperair temperairly temperance temperaory temperarey temperarly temperary temperatory temperay temperiory temperoary temperory tempery tempoary temporaily temporally temporarilly temporarily temporay temporery temporily temporly tempory temprary temprory tenperary tenperay tenporary
temptation: temtation
ten: tan tens
tendency: tendancy
tennis: tenis tenne ternis
tennis-ball: tennis_ball
tent: tant
tenth: tent
term: tearm teme turm
terminal: termial terminel
terrestrial: terestial
terrible: teral terdal teribal terrable terriable
terribly: terrible
terrifies: terrify's
territory: teritory
terrorists: teroists
terrors: terrours
testimony: testamony testomony
tests: test
text: texed
than: that then
thank: thak think
thankful: thankfill thankfull
thanking: thinking
thanksgiving: thankgiving
that: and anthe at but dat haen hart hat net tandt tat than thatt thay the theat thet theut to vat
that's: that thate's
the: I a an hte my t tehe th that thee these they thi thw tie to tu
theatre: theather
their: the ther there these they thier thrir
them: tham the then there
themselves: themself themselfs then_sloses
then: than the them
therapists: threapists
there: lare tere th thar thare the thear thei their theire thene ther theres they theyr'e theyre thie thier thir thire thise thre thwre
there's: theirs
there_had: therad
therefore: there_for therefoe therefor therfore
thermawear: thermawere thermawhere
these: tes the theas thease thees theis there theres thes thess theys this thiys
theses: thses
they: thah thaire thar that thay the thea their theire ther there thir thy
they'll: their
they're: the their there thier
thick: thik
thief: theaf thefe theif
thieves: feste fevers theifs theiths theives thesve thevies thiefs thies thifeves thives
thimble: thimbel thinble
thin: feh fein fen fib fihh fin fine fing finn flen fomer foram frene fthi inen lind rune sin than the thehe then ther thiden thine tin tine tint wie
thing: then thin things thng ting
things: fens thigs thing think tings
think: thick thinck thing thingk thinke tink
thinking: thinging thinkin
third: firld their therd thrid thurd
thirdly: thirdy
thirteen: therteen
thirty: thrity thurty
this: thes thhis ths thus tish
thorough: furrow terrol therior thero therol therow thoreaugh thoro thoroughal thoroughl thoroughly thorow thorugh though thoughtu thoura thourah thoural thourgh thourghl thourghly thourgho thourl thourogh thourough thourrow threough thrlow thro throroth throrough throuel through throughal throughl throughor throught throur throurgh throw throwal thrugho thural thurol thurough thurow
thoroughly: therally theroly theroughly thorally thorly thoroghly thoroly thoroughally thoroughily thorouly thorughly thorught thougherly thoughly thoughtly thoughty thourally thouraly thourely thourghally thourghly thourily thourlly thourly thouroghly thouroly thourough thouroughly throroughly throughely throughly throughtly throughway throughy througly throuly thuroughly thurouly torrially vacancy
those: thoes thoese thos
though: tho thou thow through
thought: that thont thorght thorught thot though thougt thourght thoy throght throught
thoughtful: thought_full
thoughtlessly: thorought
thoughts: thorts thoughs thought
thousand: thousend thousnand
thread: thred
threat: thret
threatened: thretened
three: thee there threee tree
three_quarters: threequaters
threw: thowed through throw
throbbing: throbing
through: rowit tho threw throught throut throw
throughout: thoughout throuout
throw: thow through
throwing: throws
thrown: thron throne
thumb: thum
thunder: thounder
thus: thous
ticket: tiket
tickled: tickeld tickeled
tidied: tiyeded
tidying: tiding
tied: fried tad taid tareed teid teyd thered thid tiad tib tid tide tided tidit tie tieded tieed tih tind tinet tird tired tiyed toded tried tyed
tig: tige
tiger: tigar
tight: tite
tightening: tighting
till: tell tile
timber: tember tenber
time: tame thim tiem tim tine
times: time tims
timetables: time_tables
timid: timed
timing: timeing
tin: teine ten
tiny: tine tiney tinu
tip: tep
tire: tier
tired: tiered tiried tried
tiring: tiering
title: tittle
titles: tittles
to: of ot ro th the too tow two
to-day's: to-days to_days todaies today's todays todays' two_days
toad: toed
toads: roads
toast: tost
tobacco: tobacko tobaco tobbaco
toboggan: conboggon tabbogan tabbogon tabogan tabogen taboggan tabogoon taboog talbogan talogon terbogen tobacon tobag tobagan tobaggan tobagon toban tobboan tobbogan tobbogen tobgen tobogan tobogane tobogar tobogen toboggen tobogn tobogon tobogone tobogurn tobon tobugon torbogen
tobogganing: tobboganing
today: to_day
toe: tow
together: to-geather to_geather to_gether to_gever togather togearthy togehter togethers
toilets: tiolets toilats toilects
told: teld to todle toll tolld
tolerance: tollerance
tomato: tmato tomto
tomatoes: tomatos
tomboy: tom-boy tom_boy
tomorrow: tommorrow tomorow
ton: tun
tongue: tounge tun tund
tonight: tonit
tonnage: coneage countages cunage cuniage cunnage cunnidge punish talmuge tinage tomage tonag tonage toneage tonege toneus tonige tonnauge tounage tumage tunach tunage tunegg tuneouge tunish tunnadge tunnage
too: to tw two
too_much: tomuch
took: look take tok toke tuck
tool: tol
tools: toles tooles
tooth: toth tuth
top: tap
torches: toches
tore: tor
torn: tourn tron turn
total: totle
totalitarianism: totalitarionism
totally: totaly
touch: tuch
touched: cher chuched stuched tacah tache tashed tesded thach theed thucht tiups toached toched toght tosh tost touch tougched toughed touh toulched toure toutched trosh tuch tuchd tuched tucked turst tuses tush tust tusted tutet
tough: tuff
tourers: turrers
tournament: atournament hermit teramant termament termanent termenent termenont terminent ternament ternement ternimate terniment tormenment tormentement tornament tornamently tornement torniment tornment torrment tounement tourament touranment tourement touremount tourimant touriment tourmad tourmament tourment tourmment tournamant tournanent tournate tournement tourneyment tourniment tournmant tournmeant tournment tournnament trounment tuarninent tunement turament turement turimant turmanent turment turminate turminent turmonent turnament turnement turnent turnimant turniment turnmant turnment turnoments
toward: tord
towel: towl
town: toun tower
toys: toy
trace: trase
track: trak
tracksuit: crake_suit crast crot_sot fraske_stinte san_sote tack_soot tack_sote tack_tot tacksot tak_sar taksot taren_deng tark_suit tarseet thiksawet thracant thret tone_setch tornk_suint tour_soter trac_soot trac_suit trach_soot track-sl track_saut track_soot track_suite tracksoot tracksurt tracsant tracsute tract_siut trak-suit trak_shute trak_soat trak_suait trak_suit trake_suit treksot trik_sack trock_soot trockset
trade: trad trede
traditional: traditonal
traditionally: traditionaly
traffic: cafic craffeck drafec farolc peraffic roads taafic taame tac tacter tafeate tafic tafter tairer tale taraf tarffic tarnftian tate tatif tatlek taveging tavek tavit terrec thaiech tiatic tinict tiornef track tracky trafack trafec trafeck trafek trafet traff traffc traffek traffi traffice traffig traffik trafic trafice trafick trafik trafit traie traifec traik traph trare traveck travic travick treffer trfick trofek
tragedy: tradady tradagcy tradedy tradedys tradegdy tradegy tradety tradgady tradgedy tradgety tradgey tradgidy tradgiety tradgity tradgu tradgy tradialy tradicle tradidy tradigdy tradige tradigy tradity tradjedy tradjetive tradjudy traduay tragadies tragady tragaty tragdedy tragdy tragedidy tragedies tragedity tragedty tragerdy tragety tragidity tragidy tragity tragually traity trajedy transidy trasade trdgedy tredige tredigity tredigy trodgety trodgity trodigy trogeyey tryadry
train: tarn tegne thain traine trame tran trani trein trian trime trine trion
training: charing taining taning tarin train traing trainning traning tranning trianing trichting trying
tramp: tranp trap
trams: trambs
tranquility: tranquillity
tranquillity: tranquility
transactions: trasactions
transferable: transferrable
transferred: dransfered tranceferred tranfer tranfered tranferred transefered transeferred transfared transfeared transfer transferd transfered transferr transfierd transford transfred transfuned transfur transfured transifered transsfherd transufere trantefered trasfered
transmission: ransmission
transportability: transportibility
trap: trape
travel: travell travill travle
travelled: travald traveled
traveller: travler
travelling: traveling travling
treasure: tresure
treasury: treasurey
treat: treet
treated: treeted treted
tree: tee tre
trees: threes tres tress
tremendously: tremendisle
trestle: tresle
trial: trail
trial-run: chanran chid_run coyal_run nir ril_ron run tail_run taill_run tale_run talyron tarl_ran thiyll_rane tihen_van tile_run tirel tisw_run trail trail_ran trail_run tral_run trial_in triale_run triall_run trid_ran tried triel_run triell_run trien_run tril tril_run trile_run trill_ran trill_run trille_run triol_run trirelrun trler_run troll_run try_run tryel_run tryle_run trylerun turall_ran
triangular: triangulaur
trick: trik
tried: tride tryed
tries: trys
trifle: triffle
trilby: trillby
trim: trem
trimmed: trimed
trip: trim tripe
tripped: trip
tripping: triping
triumph: tinaup tirumph trail trampht triam triamph triampht trianph triaumph trijant trile trimph trimunph trimuph tripamph triufen triump triumphant triumphed triumphet triumpt triumpth triunysh triuphy truimped truimph trumiphum trumph tryamp tryamph tryampth tryamth tryanph tryant tryenth tryimp trymp trymph trymphant trympth trymth trymunpth trymuph trymupt trynmpt tryumph tryumpht tryumphump tryumpth tryunfunt tryunkh tryunnt tryunph tryunphy tyranpth tyromph tyront
trivial: triveal
trolley: trolly
troop: troup
trotting: choting galaing goting retotig roting tain tarning tate tatt teing there thoting tireing tocting toght toling toneing toning tooting tor tording toring toroing torting toting totting troding trooting trorting trot troten trothing troting trotung trouting trting truting truty ttoring
trouble: touble troble truble
trouble-causer: trouble_causer
trouble-maker: trouble_maker
troubles: trubbles
troublesome: troblernsom
trousers: trouse trouses trousos trowsers
trout: trot
truck: truk
truculent: trucculent
true: troo trow
truly: truely truley trully
trunk: tronk
truth: thruth troth tuthe
truthful: truthfull
truthfully: truthfall
try: tine tri
trying: triing tring triyng
tub: tab tob
tube: tub
tuck-shop: tuck_shop
tunnel: tunel
turkey: turky
turn: trun
turned: dilay frened tain take tand tande taned tank tann tanr teand teaned tearnd tearned teart tedt tend tened terd tered terened terer ternd terned tet teurned tian tining tit tod toda tode ton tond tonet tont tord tound tount trend trind trnd trond trud trued trund truned tud tund tuned tuneed turd tured turend turened turn turnd turrned
turnip: turnup
turtle: turtel
twelfth: twelth
twelve: twelf twelv
twenty: tewenty
twice: twis twise
twilight: twlight
twin: twen
two: to too tow twe wot
two-faced: two_faced
tying: tieing
type: atiped atoeye lait taep tafp tap tape tepy tiap tibe tiemp tiep tight time timp tinent tip tipe tiurp tiye top tope tpep traep trye twip typ tyre
typewriter: typwriter
typhoid: tifoid tyfoid
tyrannical: tyranical
ultimate: ultimatel untimate
ultimately: ulimately
umbrella: umberalla umberella umbrela unbrella
unable: onable unabel
unacceptable: unaceptable
unambiguous: unabiguous
unanimous: Unamanius Unamious amius annymus anonymous enaumous eumamious eunaminus eunamous inamimus munaniuous sallanous umamilus umamous umanaress umanmuse umionus unacious unaiminous unaimous unaimulas unamaious unamaless unamamous unamamouse unamanious unamanous unamanus unamatous unamenous unamies unamimus unaminonus unaminous unaminuous unaminus unamious unammious unammius unamnious unamomus unamonus unamos unamous unamus unamuse unamusts unanabus unanamious unanamous unanamus unanamuse unananois unananucs unananus unanasmons unanemous unaniae unanimise unanimos unanimoses unanimus unanimuss unaninous unaninus unanious unanis unanmous unannamous unannanus unannimous unanomous unanonus unanouis unanously unanumas unanumous unanus unariowas unatimas unenamous uniamimus uniamoes uniamones unimas uniminus unimous uninamous uniom uniomus unionous unitomious unminus unmnus unnadimus unnambus unnames unnamious unnamos unnamous unnanamous unnanimous unnanomous unnanumus unninote unnous unomanious unomise unomust unoniums unonomious unsannamous unumanious ununmious ununumus youmanles younamenous younamess
unavailable: unavailble
unbearable: unbearible
unbeliever: unbeleiver
uncle: uncil
uncomfortable: uncomfortal uncomftable uncomfterble unconfortable
unconnect: unconect
unconscious: unconcious unconsious unconsors
unconvinced: unconviced
uncritical: uncritiacl
under: andr undr
undernourished: under_norished
understand: anderstand andsadit andseit downedstaed udderstand uderstand udhirsand udstair unberstand undastand under-stand undersand undersdand underslad undersland understain understanit understant understantit understend understood undesand undesland undessand undestand undisandit undistand undratit undsid undstad undstand undstone undurstand unedstan unstand urset
understandable: understadable
understanding: under_standing understanting undestanding
understood: understud undestood
underwear: underware
undoubtedly: adoubtadly indoubladly ondoutally ontable ontotadly udoubtly undaughtly undobtabily undobtedly undolley undotaley undotally undotaly undotedaly undottedly undoubaly undoubatly undoublably undoubledly undoubledy undoubly undoubt undoubtable undoubtablly undoubtably undoubtadley undoubtadly undoubtaially undoubtal undoubtalady undoubtally undoubtaly undoubtatly undoubtavely undoubtealy undoubted undoubtel undoubtely undoubtetly undoubthly undoubtiably undoubtidly undoubtily undoubtley undoubtlly undoubtly undoubtoadly undoubttedly undoubttily undoubty undoughtably undoughtedly undoughtly undouplably undouptaly undoutably undoutadly undoutaly undoutbablly undoutedly undoutetly undoutively undoutly undovt unduitable
unearthly: unerthly
unemployed: amped annepld auninpeld enumployed ininblid umbempoy uminblyed umpoyed un unely unemploeyded unemploy unemployed unempoled unempolyed unenployed unepyld uneyed unibloyed unimployed uninbud uninepould uninpiod uninplerd uninploed uninplord uninployd uninployed unipiord unmped unpalled unploder unployed unpole unpoulyed unterpoid unyep uploperd
unemployment: unee
unencompassable: unemcompassable
unenlightened: unenlightend
unequalled: unequaled
unequipped: unquped
unequivocally: unequivocaly
unexpected: anespected inexpected undredspetied unepcted unespected unesptive unexcepted unexcpected unexcpeted unexepted unexpecked unexpect unexpend unexpercted unexperted unexpeted unexpickted unexpleaded unexpted unexsected unexspected unispected unxspected
unfavourites: unfavorites unfavortes
unfinished: unfinised
unforeseen: unforseen
unforgettable: a_forgetha_ball and_for_pall anfergeterball anforgetabul anforgotable anuforflit exfigetable forngetable nonformgetele on_for_getey onforgetable ufor_get ufor_getble ufor_getible uforgetable uforgetle uforgettable un_for_getterbl un_forgeter_bole under_a_asst undforgetall uneforars_bele unfergetable unfor unfor_geterble unfor_gettoble unforegetably unforgatealbe unforgattable unforgeable unforget unforget-able unforgetabal unforgetabale unforgetable unforgetably unforgetbl unforgetedl unforgeteful unforgeterble unforgeterbol unforgeterfall unforgeterld unforgeterply unforgetful unforgetine unforgetorfell unforgetrel unforgettalbe unforgetteable unforgetterball unforgetterbull unforgettible unforgettle unforggetable unforrgettable ungletevel
unfortunate: anfortunate enfortunate infortant infortiune uafotunat umforturant unforetunate unformenant unfornate unfortanate unfortenat unfortent unfortiant unfortinate unfortionate unfortnate unfortuanate unfortuant unfortuate unfortumate unfortument unfortunante unfortunat unfortunated unfortune unfortuneate unfortunet unfortunitate unfortunte unfortuonate unforunate unfotunae unfournate unfurtunate unportantion
unfortunately: Unfortunately onforthantly onfortinly onfortionlly onfortogoinil onfortumatly unforludally unfornaaley unfornally unfornatly unfortally unfortanately unfortanetly unfortantily unfortantly unfortinately unfortinatly unfortintilly unfortionately unfortionatly unfortnally unfortnatly unfortnitely unfortually unfortuantally unfortuantley unfortuatly unfortunaly unfortunantly unfortunate unfortunatly unfortuneately unfortuneatly unfortuneilly unfortunely unfortunently unfortunetally unfortunetly unfortunily unfortunitly unfortunly unfortuntly unfortunutly unfortuonly unforumatly unforunially unforunitly unfotunalty unfourtenly unfurtunally unfutunally
unhappy: anhappy onhappy un_happy
unhygienic: unheigenic
uniform: iniform unaform unform unifore youeform
union: unioun
unique: uneque
united: unighted
universal: unerveral unerversal
universally: universaly
university: unerversity universaty universit unversity
unjustified: unjustefied
unless: unles usless
unmistakable: unmistakeable
unnecessarily: unessasarily
unnecessary: innecessary unecessary unessessay
unnoticed: unnotie
unparalleled: andpiotou anparelle apparrelled empalerleld parrealled umparralled un-parrallel unapparralled unblale unpall unparale unparaled unparalel unparalelled unparalled unparallel unparalleld unparallelled unpareled unparelelled unparelled unparelleled unparielled unparlled unparlleled unparolled unparraled unparralel unparraleled unparralled unparrallel unparralleled unparreled unparrelede unparrelled unparrled unparrowllede unperalld unplaled unpovaly unproloud uparrelled
unpleasant: unpleasent unplesant
unravelled: unwravelled
unrecognizable: unrecocniseable
unresolved: unresloved
unruly: unrooly
unsafe: unsf
unscramble: unscamble
unsuccessful: unsuccesful unsucessful
unsupported: unsuported
unsymmetrical: unsyme
untidiness: untideness
untidy: untiede
until: intal untill untl
unturned: unterned
unusual: unusal
unusually: Six onusewally onusually unnusually unreualy unsual unsually unsully unually unuasallily unuasally unuasley unuaslly unuasually unuasualy unuasully unuasuly unuaualy unusally unusaly unusaully unuserally unusly unussaly unusual unusualy unyo usally useualy usually usualy
upheavals: upheavels
uphill: upwill
uphold: uphole
upon: apon opon
upper: uper
upset: up_set
upstairs: upstaires
urge: earge erge
urgency: urgu
urgently: ungertly
us: a ares as use
usable: usu
usage: useage
use: used yous yowes
used: us us't use usedf uses uset ust usued you yourst yous yoused youst
used_all: uasall
used_to: use_to uses yosto you yousto
useful: usefull usful usfull
usefulness: usefullness
useless: usless
user: uers
using: useing
usual: usal use_all usly usually usueal
usually: usal usally usaly usauly useully ussually usualy yousel
usurious: usurous
utility: utillty
utilized: utalised
utmost: upmost uttmost
utterance: utterence
vacancies: faconcey focam reckness vacaciencies vacaines vacakencies vacancease vacances vacancieces vacancis vacancises vacancsy vacancy vacancy's vacancys vacanies vacanous vacanses vacansess vacanseys vacansies vacansises vacantance vacantce vacantces vacantcies vacantcisses vacantcy vacantcys vacanteses vacantesies vacanties vacantinees vacantises vacantseys vacantsies vacantue's vacantuncies vaccancies vaccounces vacencies vacency vacentces vacentcy vaciancies vaciancys vaciencies vaciencys vacienties vacincies- vacincy vacincys vacinices vacinsas vacintyes vaciouney vackancey vaconcies vaconconcys vaconices vacontcies vacpmsy vacunceys vagancies vainees vancancies vancencies vancies vancious vancous vancy vanencies vankencys vencomies
vacancy: facountcy vaansy vacance vacances vacancey vacancie vacancies vacancity vacanes vacaney vacanies vacanse vacansey vacansie vacansy vacant vacantcies vacantcy vacantency vacantes vacanticy vacantise vacantsey vacantsy vacany vacanze vacatcy vacatence vaccance vaccancy vacency vacentisy vacentscy vaciency vacincy vackency vaconcy vacuncy vacuntcy vagrancy vakensy vancancey vancancy vancay vancey vanciety vancy vankies vavancy
vacant: vacent
vacation: vacashon vaction vakation
vaccination: vacinnation
vacillate: vaccilate
vagabond: aros bagcle boafay bonong fagabond gad stnveah vabone vabong vacabong vad vadgne vag vaga vaga_board vagaband vagabong vagabord vagabound vagabout vagach vagacy vagadone vagalal vagalond vagand vagang vaganong vagband vagbond vagbonley vagebond vagegaboud vagenbond vager vagetbone vaglah vagletrre vagobond vagol vagonbond vagopond valgbond van vanadame vanauanad vandand vaon vaot vargaboard vargonede vargorbrard vaya veaneys vereneuee vguobad vogabond von yonabond
vaginas: virginas
vague: vage vaig
vain: vane
valentine: valintine
valley: fal vailey vale valelle valey vallay vallaye vallery vallie valliy vally valy vary vaty velei vialla vieavel villge villy vleay vlet
valuable: valubale valuble valueable
value: vaule
van: anthe can fan fane farn fune vam vand vane vanr vant veam vend vene vetfei vin von vuin vun
vandalism: vanderlisium vanderlism vandolism
vandals: vandles
variable: vaiable varable varible
variant: vairiant
variations: verations
varied: vqried
variety: variatry varity
various: besthe ferehrs thereus vaires vairi vairious vairous vairouse vareious vareous varies varios varisous varius varsus varus vearious veis veludus veraers vereas vereouse veres veresly vereus veries verious verius veriusse veroes verreas verress verrest verreus verst verus veryass veryius vreus
varnish: vanish
vary: varie
vast: vaste
vector: vectore
vegetable: vegatable
vegetables: vegdaballs
vehicles: vehicules w
velvet: velvit
vengeance: vengance
ventilated: dentilated vedulated venlatated ventalated ventallated venteariated vented ventelaind ventelated ventenlited venterelated venterlated ventialed ventilate ventilented ventillated ventilt ventlated ventolated ventorlated ventulated venturlated ventylated vetlettd vimleated vintilated wellvented
venture: vanture
verruca: varooka
versatile: versitile
versatility: versility
verse: verce
vertical: verticle
very: an fere ferod fery lerey vehr ver vere verey veri verry veye wint
vessel: vessal vessle
vice: vise
vicinity: visinity
victim: victom
victuals: vituals
view: ve veiw vew
viewed: feade feiwed fewed ford foued fued fuid fused moved new renewed revead reveiwed revewed reviewed thewd vard veay veid veided veied veiued veived veiwd veiwed verday_at veuwed vewd vewed veyed vieded vieved viod viwed voad vod voed voghed vold vould vouwed voved vowed vued vurd you'd
vigorous: vigourous
vilify: villify
village: villiage villige
villain: villian
vine: vin
vinegar: vinigar
violence: valience vialance vialounce vialuse vilalest vilance vilelence vilence vilents vilets viliance villi villonents viloant viloence vilounce vine violance violent violents violets violience violin violince violonce voilance voilence volience volince
violent: filent
violet: vilet voilet
violin: vioiln voilion volin
violins: voilins
virtually: vertually
virtue: fertue fertued ferture furtue verchew verchu verchude verchue vergue verters verterue vertie vertieu vertive verto vertu vertue verture verue victure virchu virercut viricheu virteau virtiou virtou virtrue virtu virtuals virtues virtuge virture vurtue vurtued
virtues: Virtues firtues varuse verchews verchoose verchues verchuse verchuses vercuded vergues verguse verjuous vertchuse verteous vertious vertrue vertuals vertucherys vertue vertue's vertues vertuies vertures verturs vertuse vertutres veruse verusete vetucus vetutuse viotuls virgues virteous virtue virtue's virtueous virtuies virtuious virtures virturius virturs virtus virtuse viruch vitures vurage vurlus vurtues vurtuges vurtutes
visible: phisical usuable vesiable vesible vessiable visable visiable visibabe visibal visibale visior visitable vissable vissible visuable visuble
visibly: visably
visit: visite vist viste
visited: fied fisated fisited fisiten fisitied thisited vesertid veseted vested vicitet vieset vietied vinted visde visead vised viset viseted visetered visetet visied visit visitd visiteted visitid visitied visitor visitored visorted vissed vissited vist vistd viste visted visteol visterd vistered visteted visthed vistid vistied vistit vistited vistiten vistored vited viteted vitoin vitter vizet weted wist
visiting: visting
visitor: vistor
visitors: vistors
vitamins: vitamines
vivid: virde vived
vividly: vidally vididly vivadly vivedly
voice: voise vose
volume: valume volum
voluntary: volantary volantry
volunteer: volenteer
vote: voat voet vot
voting: voteing
voucher: Valchure bockers boucher bunchur fauture filture foucher foulture overur valchar valchor valture vaucher viotuter voacher vocher vochur vochure vocur vogure volcher volchor volchure volfure volture voluture vorue vosher votcher votfure votour votur voture voucer vouch-her vouchar vouchered vouchers vouchor vouchure voucur voueture vouger voughte voughture vougure voultures vouncher vouscher voutcher voutchers vouter voutere vouthur voutiers voutuer vouture vowchure vowture vuleure vultier vulture vultures
voyage: voage
vulgar: Volgor bloger boulder bowlder bulgar falgar fulgur juglar rologer valgar valger valgor valguar valgue valguor valgur valgure valvar vaulgar vaulger vaulgur velgary vogular volager volga volgar volger volgor volgur vollgar volugar volugard voulager voulgar voulger vulerunable vulga vulgare vulger vulgor vulguar vulgur vulgure vullgar vunger
wagging: waggin
waggish: wagish
waggon: wagen wugom
waist: wast waste
wait: want wate
waited: wated
waiting: waitng wati wating watting
waitress: waiteriest
wake: waek
walk: wake wok work
walked: waiked wake waked walk walk't walket walkt warkd warkt warkte wart whorter wllot wokt worked workt wort wucde wurtt
walkie-talkie: walky-talky
walking: alkeig marcing wacing wacking waild wakeing waking wakking wakn wallking wank wark warking waulking week wilk wilking woing wokin woking wokking wolking wolling wolwing working wound
walks: walk
wall: woll
wander: wonder
want: wants went wernt whant what whont won't
wanted: had pretented wald wan want wantend wantid wat watied waunt wend whated whatted whented woinr wonded wont wonted wontid wotis woulded wouted
wants: wans wantes
war: wor
warm: worm
warrant: warent warrent
wary: weary
was: his saw some uas wan wase wass way we widd wos wus
wash: wach
washerwoman: washawoman
washing: waching
wasn't: wasen't
waste: waist wate
watch: wach wacth whatch whotch woch
watched: wached watch
watching: waching
water: wather watter weter
watercolours: water_colours
waterworks: water_works
way: uay wa wye
ways: was way
we: be wee weed wen were wey when wot you
we'll: we'el
we're: where
weak: week
wealth: wealh welth
wealthy: welthy
weapons: wepons
wear: wair war ware weare were where
wearing: wa weary whering
weary: wery
weasels: weazles
weather: wether whether whetter
weave: weeve weve
wedding: weding
wednesday: wedensday wensday
weed: wead wed weede
weedy: weedey
week: weak wek
week's: weak's weaks week weeks weeks' weks wig's
weekly: weakly
weeks: week
weigh: wiegh
weighed: weighted wieghed
weight: weght weigth wieght
weighted: wagted
weights: weigths
weird: werd wierd
welcome: wellcome
well: wall will
well-built: well_built
well-educated: well_educated
well-off: well_off
well-paid: well_paid
well-suited: well_suited
well_as: will
well_illustrated: well-illustrated
went: want wen wen't wend when whent wot
were: here waer wain war was we wear weer went wer werh wey wher where whey whir why wont wore wre wree wur yer
weren't: were'nt werent
west: wast
western: westen
what: wait want wat wate weot wete whia who whot wich with woat woht woot wot wote
whatever: watever what_ever
wheat: weat
wheel: weel
wheelchair: wheel_chair
wheelbarrow: wheel_barrow
when: wane want we wen wene went wern weten whan wheh whene where whern whet whn wian will wine
whenever: when_ever
where: gaing hwere ther there war ware wart we wear wee wer were werre wet wher whrer wir with wuy
whereas: wheras
whereby: were wherby
wherever: wereever whereever
whether: weather wether wheather whetherr
which: weich wgich whch whic whih whihc whitch wich wiche wick wicth witch with withe wo
whiff: wift
while: wile wilh will
whip: wip
whisper: wisper
whistle: whisle wisal wisel wishle wishte wistle
whistling: shisterling shning swiling warcing was_fill welleings welt werting wesle west whil whilsty whirling whisherling whising whisle whisling whislling whislng whislting whissling whisteing whisteling whisterling whisthing whistiling whisting whistleing whiting whitsling whizzing wind wing wisaling wiserling wising wisling wisll wisln wissling wisting wistling wistting yesing
white: wite
whites: wittes
whitewash: white-wash
who: dae heo her ho hole hon hoo hoor hoow hor hot hou hour how hu hwo ohw onelhelh ot our ow owe roow thow want whoe whow whoy why wo woh woth wow
whoever: who_ever
whole: hole
wholesale: holesale wholsale
wholesome: holesome wholsome
wholly: holy wholy
whom: whome
whose: hose hows who's whos
why: way wiy wy yoy
wide: wa wid
widely: widly
widespread: widesread
widow: widdow wido
width: with
wife: wilf
wig: weg
wild: wile
will: ill well wiil wil with wull
willing: welling wiling
willow: wilow
win: wen wind
wind: wid win
window: windo wondow
windowpanes: window_panes
windowsill: window_sill
windows: windous
windy: winde windey
winning: wining
winter: window witer
wipe: wip
wire: wier wirer
wireless: wirless
wise: wize
wish: whish wich wis
wished: wich wisht
wishes: weiches wes weshe whes whishen whishes whishies whishis wiches wichis wis wisches wish wishas wisher wishies wishings wishis wishs wisrnt wiss wissen wist wisus withis wiws wthis
wishing: wiching
witch: which wich
with: in the we wef wefe went weth wethe wh what when wheth whin whit whith wien wif wihe wiht wihth will wint wirth wis wit wite withe wive wivr wiy wthe yethe
wither: whither
withhold: withold
within: withing
without: finet wathout weth_out wethout whit_out whithout with with-out with_aot with_out withe_out
witness: wittness
wobbly: wobberly
woke: rock wake wark weik whok wick woc wock wohy wok wonk wooc work worke
woman: women
women: mimen uing wamam wame wamen wanmen warmt warting wathes wem weman wemem wemen wemime wemin wemm wemn wemon wendmen wening weomen weomon weon werm wermen wes whoim widin wied wiem wim wiman wime wimen wimien wimin wiming wimm wimme wimmen wimmin wimmn wimn wimon wine winin winm winman winmin wmen woedon woemn wohe woine woman wome womem womeod womin womm wommen womon womow womse wona wonam wonder wone wonen wones wonnen wonon wonwin worning wowd wowen wowman wowona wumen yahey yanthr
won: one wone
wonder: aveney awonder think veary wander waud wed weder what wond wonerd worder wore woud wouda wound wounder wub wud wund wunder
wonderful: wondeful wonderfull wondrful
wondering: wondring
wondrous: wonderous
wood: wod
woods: woodes
woodwork: wood_work
wool: woll
woolen: wollen
woollen: woolen
woollens: woolens
word: ward wood
words: word
wore: war wor
work: warck wark werk wh woke wolk worke worked
worked: work workt worted
workers: work
working: warking woking
works: work
world: wald wholed wold word worde would wourld
world's: world
worn: warn
worried: woried worred
worries: worre
worry: werry worrie wory
worrying: worring
worse: wors worst wosre
worship: warship
worshipping: worshiping
worst: wart werst worse
worth: werth wherth worht woth
worthwhile: whorthwhile worth_while worthwile
worthy: worthey
would: ward wed were wet whode whort whould wob wod woild wold wollda wond wood woud wouls wred
wouldn't: woulden't wound'nt
wound: wond woned
wrap: rap
wrapped: rapped wraped
wreath: reath
wreck: reck wreack
wretch: wrech
wretched: wreched wrecthed
wrist: rist
write: right rite wire wrigt
writer: writter
writing: writeing writting
writings: writtings
written: writen
wrong: long ro rog rong ronge worng wrang wronge
wrote: laut rawtr read roat roet rohit ront rot rote roten rought rouht rount rout route wart worth wote woth wrat writ write wroght wrout wroute
xylophones: zylaphones
yacht: yahct yaht
yard: yerd
yarn: yorn
year: yea yeare yeer yer yery
yearly: yearley
yearned: yerned
years: yares yars year yeas yeers yeras yers yesars
yell: yeal yel
yellow: yello
yeoman: yoman
yes: yas
yet: yat
yield: yeild
you: na uoy w yau yo your yow yoy yuo
you'll: you'l your
you're: your
young: lar yae yem yoand yong yorug youg your
youngest: youngeist
your: ore ure yer yere yor yore you young youre yowr
yours: yors
yourself: youself
youth: uth yuth
zealous: zelous
zenith: zeenith
